111111111111
11111PECCC11
111111111111