111111111111111111111111111111111111111111111111111111111111111111
1C0000000000000000000000000000000000000000000000000000000000000001
100000000000000000000000000000000000000000000000000000000000000001
100P0000000000000000000CC00000000000000000000000000000000000000001
100000000000001000000000000000000000000000000000000000000000000001
100000000000000000001000000000000000000000000000000000000000000001
100000000000000000000000000000000000000000000000000000000000000001
100000000000000000010000000000000000000000000000000000000000000001
100000000000000000000000000000000000000000000000000000000000000001
100000000000001000000000000000000000000000000000000000000000000001
100000000000001000000000000000000000000000000000000000000000000001
100000000000001000000000000000000000000000000000000000000000000001
100000000000001000000000000000000000000000000000000000000000000001
100000000000001000000000000000000000000000000000000000000000000001
100000000000001000000000000000000000000000000000000000000000000001
100000000000001000000000000000000000000000000E00000000000000000001
100000000000000000010000000000000000000000000000000000000000000001
111111111111111111111111111111111111111111111111111111111111111111