111111111111111111111111111111111111111111111111111111111111111111
100000000000000000000000000000000000000000000000000000000000000001
100000C00000000000000000000000000000000000000000000000000000000001
100P0C000000000000000000000000000000000000000000000000000000000001
10000C000000001000000000000000000000000000000000000000000000000001
1000E0000000000000001000000000000000000000000000000000000000000001
100000000000000000000000000000000000000000000000000000000000000001
100000000000000000010000000000000000000000000000000000000000000001
100000000000000000000000000000000000000000000000000000000000000001
100000000000001000000000000000000000000000000000000000000000000001
100000000000001000000000000000000000000000000000000000000000000001
100000000000001000000000000000000000000000000000000000000000000001
100000000000001000000000000000000000000000000000000000000000000001
100000000000001000000000000000000000000000000000000000000000000001
100000000000001000000000000000000000000000000000000000000000000001
100000000000001000000000000000000000000000000000000000000000000001
100000000000000000010000000000000000000000000000000000000000000001
111111111111111111111111111111111111111111111111111111111111111111