111111111111111111111111111111111111111111111111111111111111111111
10000000000000000000000000000000C000000000000000000000000000000001
100000000000000000000000000C00000000000000000000000000000000000001
100P00000000000000000000000000000000000000000000000000000000000001
100000000000001000000000000000000000000000000000000000000000000001
10000000000E000000001000000000000000000000000000000000000000000001
1000000000000000000000000C0000000000000000000000000000000000000001
10000000000C000000010000000000000000000000000000000000000000000001
10000000000C000000000000000000000000000000000000000000000000000001
100000000000001000000000000000000000000000000000000000000000000001
100000000000001000000000000000000000000000000000000000000000000001
100000000000001000000000000000000000000000000000000000000000000001
100000000000001000000000000000000000000000000000000000000000000001
100000000000001000000000000000000000000000000000000000000000000001
100000000000001000000000000000000000000000000000000000000000000001
100000000000001000000000000000000000000000000000000000000000000001
100000000000000000010000000000000000000000000000000000000000000001
111111111111111111111111111111111111111111111111111111111111111111