111111111111111111111111111111
11P0C1100000000000000000000001
111111111000000100000000000001
1111111001000000000000C0000001
1000000000C00000000000000E0001
100000000000000000000C00000001
100000100000000C00000000100001
100000000000000000000000000001
100000000000000000000000000001
100000000000000111000000000001
100000000000000101100000000001
100000000000000111000000000001
100000000000000000000000000001
100000000000000000000000000001
100000000000000000000000000001
100000000000000000000000000001
100000000000000000000000000001
100000000000000000000000000001
111111111111111111111111111111