111111111111111111111111111111111111
100CCCCE0000000000000000000000000001
100000000000000000000000000000000001
1P0000000000000000000000000000000001
100000000000000000000000000000001001
100000000000100000000000000000000001
100000000000000000000110000000000001
100000000000000000000000000000000001
100000000000000000000000000000000001
100000000000000000001100000000000001
100000000000000000000000000000000001
100000000000001000000000000000000001
100000000000000000000000000000000001
111111111111111111111111111111111111