111111111111111111111111111111111111
100CCCC00000000000000000000000000001
1P0000000000000000000000000000000001
100000000000000000000000000000000001
100000000000000000000000000000001001
1000000000001C0000000000000000000001
100000000000000000000110000000000001
100000000000000000000000000000000001
10000000000000000C000000000000001001
10000000000000000000110000000000E101
100000000000000000000000000000001001
100000000000001000000000000000000001
100000000000000000000000000000000001
111111111111111111111111111111111111