111111111111111111111111111111
111111100000000000000000000001
110000011000000100000000000001
1111111001000000000000C0000001
1000000000C00000000000000E0001
100000000000P00000000C00000001
100000100000000C00000000100001
100000000000000000000000000001
100000000000000000000000000001
100000000000000111000000000001
100000000000000101100000000001
100000000000000111000000000001
100000000000000000000000000001
100000000000000000000000000001
100000000000000000000000000001
100000000000000000000000000001
100000000000000000000000000001
100000000000000000000000000001
111111111111111111111111111111