11111111111111111111111111111111
1E000000000000000000000000000001
10100101001000000000000000000001
10100100101010110000000000000001
1P0000000C00C0000000000000000011
10000000000000000000000000000011
10000100001000000000000000000011
10000100001000000000000000000011
10000100000000000000000000000011
10000000000000000000000000000011
10000000000000000000000000000011
10000000000000000000000000000011
10000000000000000000000000000011
10000000000000000000000000000011
10000000000000000000000000000011
11111111111111111111111111111111