111111111111111111111111
1P0001000000000000000001
100001000000100000000001
100000C00000000000000001
100000000000000000000001
100000000000100000000001
100000000000000000000001
1000001000000000000C0001
100C00000000000000000001
100000000000010000000C01
10000000000001000000E001
100000001000000000000001
100000000000000000000001
100000000000000000000001
111111111111111111111111