111111111111111111111111
100000000000000000000001
101000000000000000000001
101000000000100000000001
100000000000000000000001
100000000000000000000001
100000000000100000000001
100000000000000000000001
10000010000P000000000001
100000000000000000000001
100000000000010000000001
10000000000001000000E001
100000001000000000000001
100000000000000000000001
100000000000000000000001
111111111111111111111111